# mapping for standard exif tags
# format: tag key = exifread's tag key
Image Width=EXIF ExifImageWidth
Image Height=EXIF ExifImageLength
Date Taken=EXIF DateTimeOriginal
F Number=EXIF FNumber
ISO=EXIF ISOSpeedRatings
Focal Length=EXIF FocalLength
Focal Length In 35mm=EXIF FocalLengthIn35mmFilm
Exposure Time=EXIF ExposureTime
Exposure Program=EXIF ExposureProgram
Exposure Mode=EXIF ExposureMode
Exposure Compensation=EXIF ExposureBiasValue
White Balance Mode=EXIF WhiteBalance
Orientation=Image Orientation
Scene Capture Type=EXIF SceneCaptureType
Metering Mode=EXIF MeteringMode
Sensor Mode=EXIF SensingMethod
Flash=EXIF Flash
Contrast=EXIF Contrast
Saturation=EXIF Saturation
Sharpness=EXIF Sharpness
Subject Distance=EXIF SubjectDistanceRange
Make=Image Make
Camera Model=Image Model
Lens=EXIF LensMake
Lens Model=EXIF LensModel
LatitudeRef=GPS GPSLatitudeRef
Latitude=GPS GPSLatitude
LongitudeRef=GPS GPSLongitudeRef
Longitude=GPS GPSLongitude
AltitudeRef=GPS GPSAltitudeRef
Altitude=GPS GPSAltitude
GPS TimeStamp=GPS GPSTimeStamp
GPS DirectionRef=GPS GPSImgDirectionRef
GPS Direction=GPS GPSImgDirection
#
#Drive Mode=
#File Name=
#File Size=
#File Modified Date=
#Firmware Version=
